00020000
00000000
00000000
04000090
00000000
