9120000000
0111101111
0000100001
0101111101
0101100001
0101101111
01111001