9140000000010000
0111101111010110
0000100001010110
0101111101010100
0101100001010101
0101101111000100
0111100111111101
0000000000010001
1111111110111101